111112111111111111111
100010001000000000001
111010101011111110101
101000101000100010101
101111101111101010101
100000100000001010101
101110111111111011101
101000000000001000101
101111111111101110101
100000000010100010001
111111111010111011101
100000001010000000001
101111101011101111101
101000101000101010001
101010101110101010111
101010100000100010001
101110111110111111101
100010000000100010001
101011111111101011111
101000000000001000003
111111111111111111111