111111111211111111111
101000100000000000101
101010111011111010101
100010001000100010001
111111101110101111101
100010100010101000101
101010111011101010101
101000101000001010101
101011101111111011101
101010000010100000001
101110101110101111111
100010100010001000001
101010111010111011101
101010101000100010001
111010101111111110101
100000100000001000101
101111111110111010111
100000000000000010001
111111111111111110111
100000000000000000003
111111111111111111111