111111111111111111111
101000100010000000001
101010101011111111101
101010001000100000101
101011111110101110101
200010001010001010101
111110101011111010101
100000100000001010101
111010111011111010101
100010101010000010101
111010101010101110101
100010100010100010101
111110111110111010101
101000000000100010101
101011111111101110101
101010001000001000101
101010111011101011101
101000101010001010001
101110101011111010111
100010001000000000001
101011101111111111111
101010001000000000001
101010111111111011111
101010000000001000001
101111111111101110101
101000000000100000101
101011111110111110111
100010100010100000001
101110111010101111101
100000000010000000003
111111111111111111111